##########     B
####       #####
#### ### #    ##
#### ### #######
###         ####
### ###### #####
### ###### #####
A   ############
