##########^>>>>B
####^>>>>>>#####
####^###^>>>>###
####^###^#######
###^>>>>>>>>####
###^######v#####
###^######v#####
A>>>############
